0000000010000000000000000000100000000000
0S000000100000010E0000000000100000010000
0000000010000001110000000000100000011100
0000001011111100010000000010111111000100
0000000001000100000000000000010001000000
0000000001000101110000000000010001011100
0000000000000000000000000000000000000000
0111100000000000000000000000000000000000
0000000000000000000000000000000011111111
0000000000000000000000000000000000000000
0000000000000000000000000000000000000000
0000000000000000011111111100000000000000
000001111111110000011111111100000000E000