00000000100000000000
S0000000100000000E00
00000000100000000000
00000010111111000000
00000000010001000000
00000000010001011100
00000000000000000000
00000000000000000000
00000000000000000000
00000000000000000000